.......:..
.......:..
.......:..
.......:..
.S.....:..
.......:.G
.......:..
...:::::..
.::::3.:..
.::34:.:..

100 0
press [R] to restart