...:......
...:::..G.
.....:V...
.....:V...
.....:Lq..
.....:.L0>
.....:.:::
..........
..........
..........
..........
..........
..........
.......W..
......W...
.....D.WW.
.S...W..W.
......W...

100 1
press [ESC] to pause