...........:........
...........:......G.
...........:.:::::..
...........:...V....
...WW.D....:...V....
.W.W.......:...V....
...W.W.....:...V....
...W.......:...V....
...D.......:...V...
...........:...V....
...........:...V....
...........:..:Lq...
...........:..:.L>>>
...........:..:.....
...........::::::.::
...................5
...................6
.............WW..W.7
............W.W.....
.............W.S..D.

100 -1
Use [SPACE] to speed up your companion!