....................
.S..................
.......W............
....W...............
....................
....................
...........:::::::::
.....W..........P<..
...........:...Pj...
...........:...V....
..............Pj....
...........:..V.....
...........:..V.....
..............V.....
.....W.....:..V.....
...........:..V...D.
..............V.....
...........:..V.....
......::::::..V...G.
..............V....W

100 -1
gotta go fast!