.....8.9............
.S....6......C......
......?..........s..
.......W.W..........
.....W.WW..W...:::::
.......WW......P<<<.
......W...W....V....
.........W.....v.:::
......W........v....
...............v:::.
...............V....
...............v.:::
...............v....
.....W.........v:::.
...............V....
...............v.:::
......W........v....
...............v:::.
...............V..G.
..........W....v....

120 -1
