.............................C.I...............I...C............................................
.....8..w.8.Y.x.y.z.......C..{............{..C......I...........................................
.....6...6.}.6...6..}..C......I..I.....}.....I....C...}.....}....}.....}.....}.....}............
.....z...Y...y...Z........I....C...............I....C...........................................
.S............................................................................................G.

90 -1
The battery is running out!